MXXFS|MASTERWORKS VAULT 4 SER 387|Unknown|US
DLO|DLOCAL LTD|Unknown|US
AGX|ARGAN INC|Unknown|US
TSLA|TESLA INC|Unknown|US
OBRUF|NEW EARTH RESOURCES CORP|Unknown|US
PVRS|PROVIDENCE RESOURCES INC|Unknown|US
VERTF|VERTIQAL STUDIOS CORP|Unknown|US
AXHMS|ARRIVED HOMES 3 SER HELMERIC|Unknown|US
HGLD|PATAGONIA GOLD CORP|Unknown|US
ACIC|AMERICAN COASTAL INSURANCE C|Unknown|US
AEHAS|ARRIVED HOMES SER SUNNYSIDE|Unknown|US
TRGNF|TRANSGENE SA|Unknown|US
CPPKF|FARADAY COPPER CORP|Unknown|US
DMYY|DMY SQUARED TECHNOLOGY GR-A|Unknown|US
RPC|RIDGEPOST CAPITAL INC-A|Unknown|US
PSYC|PSYC CORP|Unknown|US
SRSYF|SRS HOLDINGS CO LTD|Unknown|US
CHWE|CHINAWE.COM INC|Unknown|US
ZLNWF|ZEAL NETWORK SE|Unknown|US
STLB|STERLING BUSINESS SOLUTIONS|Unknown|US
ELIAF|ELIA GROUP SA/NV|Unknown|US
OLCLF|ORIENTAL LAND CO LTD|Unknown|US
LGMHF|LEGACY MINERALS HOLDINGS LTD|Unknown|US
PVMCF|PINE VALLEY MINING CORP|Unknown|US
FIHL|FIDELIS INSURANCE HOLDINGS L|Unknown|US
SCAXF|SPARTA CAPITAL LTD|Unknown|US
ESHA|ESH ACQUISITION CORP-A|Unknown|US
NRPI|NRP STONE INC|Unknown|US
VENU|VENU HOLDING CORP|Unknown|US
TJX|TJX COMPANIES INC|Unknown|US
RVEFS|RSE COLLECTION LLC MEMBERSHI|Unknown|US
TKHCF|KOEI TECMO HOLDINGS CO LTD|Unknown|US
GIPL|GLOBAL INNOVATIVE PLATFORMS|Unknown|US
LOMLF|LION ONE METALS LTD|Unknown|US
WGTFF|WESTGATE ENERGY INC|Unknown|US
GELS|GELTEQ LTD|Unknown|US
HKOKF|CCI GROUP INC|Unknown|US
CMPVF|COMPUGROUP MEDICAL SE & CO K|Unknown|US
ACLS|AXCELIS TECHNOLOGIES INC|Unknown|US
AHARS|ARRIVED HOMES 3 SER ARAMIS|Unknown|US
MCQEF|MACQUARIE GROUP LTD|Unknown|US
LFST|LIFESTANCE HEALTH GROUP INC|Unknown|US
COEP|COEPTIS THERAPEUTICS HOLDING|Unknown|US
DICCF|DIC CORP|Unknown|US
VMRI|VALMIE RESOURCES INC|Unknown|US
AXCG|EYES ON THE GO INC|Unknown|US
MSURF|MEDICA SUR S.A.B. - SER B|Unknown|US
AFJK|AIMEI HEALTH TECHNOLOGY CO|Unknown|US
SPIR|SPIRE GLOBAL INC|Unknown|US
HCWB|HCW BIOLOGICS INC|Unknown|US
FMBL|FARMERS & MERCHANTS BANK/CA|Unknown|US
CZR|CAESARS ENTERTAINMENT INC|Unknown|US
CCCMF|CANCOM SE|Unknown|US
UPB|UPSTREAM BIO INC|Unknown|US
RTBBF|RATHBONES GROUP PLC|Unknown|US
RCVHS|RSE ARCHIVE LLCSER-60ALI1960|Unknown|US
MWQKS|MASTERWORKS 052 LLC|Unknown|US
NPT|TEXXON HOLDING LTD|Unknown|US
BRSYF|BRAINSWAY LTD|Unknown|US
DWBOF|DAIWABO HOLDINGS CO LTD|Unknown|US
ACOG|ALPHA COGNITION INC|Unknown|US
GRGSF|GRIEG SEAFOOD ASA|Unknown|US
GOLD|GOLD.COM INC|Unknown|US
GLYYF|GLORY LTD|Unknown|US
WJRYF|WEST JAPAN RAILWAY CO|Unknown|US
OCG|ORIENTAL CULTURE HOLDING LTD|Unknown|US
GGEDU|GOLDEN GRAIN ENERGY LLC|Unknown|US
DRSHF|DRONESHIELD LTD|Unknown|US
CSGEF|CHINA SUNTIEN GREEN ENERGY-H|Unknown|US
MXLGF|MX GOLD CORP|Unknown|US
TDNT|TRIDENT BRANDS INC|Unknown|US
UPST|UPSTART HOLDINGS INC|Unknown|US
ARDMS|ARRIVED STR SER HICKORYBEAR|Unknown|US
LTNC|LABOR SMART INC|Unknown|US
RIHT|RIGHTSCORP INC|Unknown|US
CNPTF|CENTRAL PETROLEUM LTD|Unknown|US
FXCOF|FOXCONN TECHNOLOGY CO LTD|Unknown|US
PLNTQ|PROLIANCE INTERNATIONAL INC|Unknown|US
DEVM|DEVMAR EQUITIES INC|Unknown|US
RNA|ATRIUM THERAPEUTICS INC|Unknown|US
OHLDF|OKURA HOLDINGS LTD|Unknown|US
RL|RALPH LAUREN CORP|Unknown|US
KRMN|KARMAN HOLDINGS INC|Unknown|US
TSRUF|PACIFIC CURRENT GROUP LTD|Unknown|US
ARPTF|AIRPORT CITY LTD|Unknown|US
CBSU|CENTRAL BANK CORPORATION/MI|Unknown|US
AXNVF|AXION VENTURES INC|Unknown|US
SMVI|SOCIAL MEDIA VENTURES INC|Unknown|US
MWVLS|MASTERWORKS VAULT 4 SER 385|Unknown|US
PDYN|PALLADYNE AI CORP|Unknown|US
BLCO|BAUSCH + LOMB CORP|Unknown|US
HHGI|HAWAIIAN HOSPITALITY GROUP I|Unknown|US
QBTS|D-WAVE QUANTUM INC|Unknown|US
IDINF|IDI INSURANCE CO LTD|Unknown|US
GLOO|GLOO HOLDINGS INC-A|Unknown|US
GXRFF|PROSPERA ENERGY INC|Unknown|US
LTMCF|LITHIUM CHILE INC|Unknown|US
CURV|TORRID HOLDINGS INC|Unknown|US
SITE|SITEONE LANDSCAPE SUPPLY INC|Unknown|US
DLOC|DIGITAL LOCATIONS INC|Unknown|US
ELTP|ELITE PHARMACEUTICALS INC|Unknown|US
INNV|INNOVAGE HOLDING CORP|Unknown|US
PTEFF|PIONEERING TECHNOLOGY CORP|Unknown|US
LNTH|LANTHEUS HOLDINGS INC|Unknown|US
PLFRF|PALFINGER AG|Unknown|US
EVR|EVERCORE INC - A|Unknown|US
GZPZF|GAZTRANSPORT ET TECHNIGA SA|Unknown|US
TRBD|TURBODYNE TECHNOLOGIES INC|Unknown|US
PNRG|PRIMEENERGY RESOURCES CORP|Unknown|US
SNLC|SECURITY NATL CORP SIOUX CTY|Unknown|US
HSIC|HENRY SCHEIN INC|Unknown|US
NUNZ|NUNZIA PHARMACEUTICAL CORP|Unknown|US
YGRAF|YANGARRA RESOURCES LTD|Unknown|US
HLX|HELIX ENERGY SOLUTIONS GROUP|Unknown|US
AUNA|AUNA SA-CLASS A|Unknown|US
PCSA|PROCESSA PHARMACEUTICALS INC|Unknown|US
OTPMF|OPTIM CORP|Unknown|US
NXNIF|NORTHX NICKEL CORP|Unknown|US
CYDY|CYTODYN INC|Unknown|US
NURPF|NEUREN PHARMACEUTICALS LTD|Unknown|US
AFFU|AFFLUENCE CORP|Unknown|US
TTC|TORO CO|Unknown|US
CRAI|CRA INTERNATIONAL INC|Unknown|US
TSMRF|TSUMURA & CO|Unknown|US
VTEPF|VIDENDUM PLC|Unknown|US
CALZF|POLYNOVO LTD|Unknown|US
SRSIF|STRATECO RESOURCES INC|Unknown|US
RS|RELIANCE INC|Unknown|US
ALMS|ALUMIS INC|Unknown|US
NSURF|NORTH SHORE URANIUM LTD|Unknown|US
AHMA|AMBITIONS ENTERPRISE MANAG-A|Unknown|US
DKGYF|DAIICHI KIGENSO KAGAKU-KOGYO|Unknown|US
FLWLF|FLEETWOOD LTD|Unknown|US
KOSK|METAWELLS OIL & GAS INC|Unknown|US
YGTFF|GOLD TERRA RESOURCE CORP|Unknown|US
AHSJS|ARRIVED HOMES SER BRAXTON|Unknown|US
RNKEU|RINGNECK ENERGY LLC|Unknown|US
MWXNS|MASTERWORKS 197 LLC|Unknown|US
RMSL|REMSLEEP HOLDINGS INC|Unknown|US
HZGLF|HORIZON GOLD LIMITED|Unknown|US
KRLTF|KARNALYTE RESOURCES INC|Unknown|US
KHTRF|KNIGHT THERAPEUTICS INC|Unknown|US
SSNEF|SANSHIN ELECTRONICS CO LTD|Unknown|US
VINS|VINDICATOR SILVER LEAD MNG|Unknown|US
LCTSF|LECTRA|Unknown|US
RBCAA|REPUBLIC BANCORP INC-CLASS A|Unknown|US
ALPKF|ALPEK SA DE CV|Unknown|US
TKYRF|TOKYO ROPE MFG CO LTD|Unknown|US
TSOI|THERAPEUTIC SOLUTIONS INTERN|Unknown|US
MTPR|METAPOWER INTERNATIONAL INC|Unknown|US
DBX|DROPBOX INC-CLASS A|Unknown|US
SGRZ|STONEPATH GROUP INC|Unknown|US
BRVVF|QUANTUM BATTERY METALS CORP|Unknown|US
CVI|CVR ENERGY INC|Unknown|US
EAXR|EALIXIR INC|Unknown|US
OPK|OPKO HEALTH INC|Unknown|US
ACMT|ACMAT CORP|Unknown|US
NADA|NORTH AMERICAN DATACOM INC|Unknown|US
AHLTS|RSE ARCHIVE SER-2019 GIBSON|Unknown|US
CPNBQ|INTEGRATEL PERU SAA - B|Unknown|US
HLOGF|HELIUM ONE GLOBAL LTD-DI|Unknown|US
EGIL|EDGETECH INTERNATIONAL INC|Unknown|US
AACAF|AAC TECHNOLOGIES HOLDINGS IN|Unknown|US
SPGGF|SP GROUP A/S|Unknown|US
SGGEF|SAGE GROUP PLC/THE|Unknown|US
YMATF|AZBIL CORP|Unknown|US
RBGGF|RIMBACO GROUP GLOBAL LTD|Unknown|US
BXSL|BLACKSTONE SECURED LENDING F|Unknown|US
MYBUF|MEYER BURGER TECHNOLOGY AG|Unknown|US
SPFX|STANDARD PREMIUM FINANCE HOL|Unknown|US
AMOD|ALPHA MODUS HOLDINGS INC|Unknown|US
MWKES|MASTERWORKS 085 LLC|Unknown|US
SMPEF|SOUTHERN EMPIRE RESOURCES CO|Unknown|US
TAOX|TAO SYNERGIES INC|Unknown|US
TTI|TETRA TECHNOLOGIES INC|Unknown|US
RSCZF|POLARIS NORTHSTAR CAPITAL CO|Unknown|US
ANET|ARISTA NETWORKS INC|Unknown|US
GE|GENERAL ELECTRIC|Unknown|US
HOLX|HOLOGIC INC|Unknown|US
PSSEF|PONSSE OYJ|Unknown|US
HVLM|HURON VALLEY BANCORP INC|Unknown|US
PCOLF|PACIFIC ONLINE|Unknown|US
FGETF|FLIGHT CENTRE TRAVEL GROUP L|Unknown|US
SKGO|SKYBRIDGE TECHNOLOGY GROUP I|Unknown|US
BCDRF|BANCO SANTANDER SA|Unknown|US
TGB|TASEKO MINES LTD|Unknown|US
TATT|TAT TECHNOLOGIES LTD|Unknown|US
EBQLF|EBIQUITY PLC|Unknown|US
GRAN|GRANDE GROUP LTD-A|Unknown|US
CBRF|CYBERFUELS HOLDING COMPANY I|Unknown|US
ASHTF|ASHTEAD GROUP PLC|Unknown|US
PBA|PEMBINA PIPELINE CORP|Unknown|US
FCBC|FIRST COMMUNITY BANKSHARES|Unknown|US
CSGH|CHINA SUN GROUP HIGH-TECH CO|Unknown|US
RFLFF|RAFFLES EDUCATION LTD|Unknown|US
XAUMF|GOLDMONEY INC|Unknown|US
PLIXF|PRAIRIE LITHIUM LTD|Unknown|US
ZURA|ZURA BIO LTD|Unknown|US
KNOIF|KONOIKE TRANSPORT CO LTD|Unknown|US
NAPRF|NASPERS LTD-N SHS|Unknown|US
AWFDF|A&W FOOD SERVICES OF CANADA|Unknown|US
VIMGF|VIMIAN GROUP AB|Unknown|US
CWWBF|PLANT-BASED INVESTMENT CORP|Unknown|US
RSEFS|RSE ARCHIVE LLC INT SER- 03|Unknown|US
UNEH|UNIVERSAL NEW ENERGY HOLDING|Unknown|US
SUNE|SUNATION ENERGY INC|Unknown|US
TRBMF|TORQ RESOURCES INC|Unknown|US
BKUCF|BLUE SKY URANIUM CORP|Unknown|US
TKCBF|TOKAI CARBON CO LTD|Unknown|US
SCLX|SCILEX HOLDING CO|Unknown|US
GTM|ZOOMINFO TECHNOLOGIES INC|Unknown|US
MTWAS|MASTERWORKS 224 LLC-CL A|Unknown|US
NRIM|NORTHRIM BANCORP INC|Unknown|US
CYBQF|CYBERDYNE INC|Unknown|US
PLDIF|PLAID INC|Unknown|US
YELLQ|YELLOW CORP|Unknown|US
IPCMF|JASA ARMADA INDONESIA PT|Unknown|US
LEEEF|LEEF BRANDS INC|Unknown|US
BWVI|PSYCHECEUTICAL BIOSCIENCE|Unknown|US
OXBDF|OXFORD BIOMEDICA PLC|Unknown|US
UPC|UNIVERSE PHARMACEUTICAL-CL A|Unknown|US
CZAVF|CEZ AS|Unknown|US
SFFYF|SIGNIFY NV|Unknown|US
WEGOF|WESCAN GOLDFIELDS INC|Unknown|US
CGDCF|CARLIN GOLD CORPORATION|Unknown|US
SPNUF|SPIRENT COMMUNICATIONS PLC|Unknown|US
SFIGA|STAR FINANCIAL GROUP INC-A|Unknown|US
ESAUF|ESGOLD CORP|Unknown|US
HLFN|HOME LOAN FINANCIAL CORP|Unknown|US
WWPW|WIND WORKS POWER CORP|Unknown|US
EGY|VAALCO ENERGY INC|Unknown|US
GBEN|GLOBAL RESOURCE ENERGY INC|Unknown|US
YSMHF|YOSHIMURA FOOD HOLDINGS KK|Unknown|US
SMJF|SMJ INTERNATIONAL HOLDI-CL A|Unknown|US
SEED|ORIGIN AGRITECH LTD|Unknown|US
AHTYS|ARRIVED HOMES 3 SER TYTUS|Unknown|US
RFIL|RF INDUSTRIES LTD|Unknown|US
CELV|CELLEV8 NUTRITION INC|Unknown|US
CFRXQ|CONTRAFECT CORP|Unknown|US
PWRHF|PWR HOLDINGS LTD|Unknown|US
SSABF|SSAB AB - B SHARES|Unknown|US
EUEMF|GRIT METALS CORP|Unknown|US
AMPH|AMPHASTAR PHARMACEUTICALS IN|Unknown|US
TKNO|ALPHA TEKNOVA INC|Unknown|US
RBNW|RENEWABLE ENERGY & POWER INC|Unknown|US
ARSRF|AERIS RESOURCES LTD|Unknown|US
CSKD|CHINA SKYRISE DIGITAL SERVIC|Unknown|US
WNMLA|WINMILL & CO INC -CL A|Unknown|US
SPMXF|SUPERMAX CORP BHD|Unknown|US
RBBN|RIBBON COMMUNICATIONS INC|Unknown|US
HNST|HONEST CO INC/THE|Unknown|US
LB|LANDBRIDGE CO LLC-A|Unknown|US
SPYR|SPYR INC|Unknown|US
QMCO|QUANTUM CORP|Unknown|US
SKBXS|RSE COLLECTION LLC-HOM 1993|Unknown|US
THRA|THERMA-MED INC|Unknown|US
UGDIF|UNIGOLD INC|Unknown|US
AHCO|ADAPTHEALTH CORP|Unknown|US
BARUF|BARU GOLD CORP|Unknown|US
ZNCXF|ZINCX RESOURCES CORP|Unknown|US
MZDAF|MAZDA MOTOR CORP|Unknown|US
MVVYF|MOOVLY MEDIA INC|Unknown|US
HKUIF|AIRMAN CORP|Unknown|US
APGP|AMPLIPAY GROUP INC|Unknown|US
TRUG|TRUGOLF HOLDINGS INC-CL A|Unknown|US
WYNN|WYNN RESORTS LTD|Unknown|US
GTN.A|GRAY MEDIA INC-A|Unknown|US
BOXL|BOXLIGHT CORP - CLASS A|Unknown|US
MSNVF|MISSION READY SOLUTIONS INC|Unknown|US
PRKV|PARKVIDA GROUP INC|Unknown|US
ON|ON SEMICONDUCTOR|Unknown|US
ISRJF|REGEN III CORP|Unknown|US
XTIA|XTI AEROSPACE INC|Unknown|US
CWLLF|COWELL E HOLDINGS INC|Unknown|US
LZ|LEGALZOOMCOM INC|Unknown|US
IRMTF|INFORMATION SERVICES CORP|Unknown|US
ZCTSF|ZACATECAS SILVER CORP|Unknown|US
LKAI|LKA GOLD INC|Unknown|US
TIDE|TIDELANDS OIL & GAS CORP|Unknown|US
IVST|INNOVEST GLOBAL INC|Unknown|US
AKRRF|PHILLY SHIPYARD ASA|Unknown|US
MOBO|MOBILE LADS CORP|Unknown|US
ADHC|AMERICAN DIVERSIFIED HOLDING|Unknown|US
WLYW|WALLY WORLD MEDIA INC|Unknown|US
PRCK|PLACER CREEK MINING CO|Unknown|US
NEPTF|NEPTUNE WELLNESS SOLUTIONS I|Unknown|US
METCB|RAMACO RESOURCES INC-B|Unknown|US
ANSLF|ANSELL LTD|Unknown|US
NHNKF|NIHON KOHDEN CORP|Unknown|US
ANANF|ANANDA DEVELOPMENTS PLC|Unknown|US
SVLT|SUNVAULT ENERGY INC|Unknown|US
RSERF|RESERVOIR CAPITAL CORP|Unknown|US
HAPYF|HAPPINET CORP|Unknown|US
GENPF|GENIX PHARMACEUTICALS CORP|Unknown|US
FFXDF|FAIRFAX INDIA HO-SUB VTG SHS|Unknown|US
KEYUF|KEYERA CORP|Unknown|US
QTCI|QUANTUM CAPITAL INC|Unknown|US
ARTV|ARTIVA BIOTHERAPEUTICS INC|Unknown|US
STOHF|EQUINOR ASA|Unknown|US
HZNFF|HORIZON OIL LTD|Unknown|US
CNO|CNO FINANCIAL GROUP INC|Unknown|US
FOSUF|FOSUN INTERNATIONAL LTD|Unknown|US
COO|COOPER COS INC/THE|Unknown|US
SEER|SEER INC|Unknown|US
YZCHF|YANKUANG ENERGY GROUP CO-H|Unknown|US
AZ|A2Z CUST2MATE SOLUTIONS CORP|Unknown|US
FABFF|FAB-FORM INDUSTRIES LTD|Unknown|US
COKE|COCA-COLA CONSOLIDATED INC|Unknown|US
BKZHF|SANTANDER BANK POLSKA SA|Unknown|US
SGGDF|SAGE GOLD INC|Unknown|US
CGECF|COGECO INC|Unknown|US
VRSEF|VERISANTE TECHNOLOGY INC|Unknown|US
MWRHS|MASTERWORKS 268 LLC|Unknown|US
GIGPF|GIGA PRIZE CO LTD|Unknown|US
XFABF|X-FAB SILICON FOUNDRIES SE|Unknown|US
SLM|SLM CORP|Unknown|US
SOBR|SOBR SAFE INC|Unknown|US
CLILF|CAPITALAND INVESTMENT LTD/SI|Unknown|US
CTALF|ARAXI LTD|Unknown|US
HAVLF|HAVN LIFE SCIENCES INC|Unknown|US
UBYH|UBUYHOLDINGS INC|Unknown|US
VTGDF|VANTAGE DRILLING CO|Unknown|US
TUGAF|TUGA INNOVATIONS INC|Unknown|US
RIGL|RIGEL PHARMACEUTICALS INC|Unknown|US
APYP|APPYEA INC|Unknown|US
CPORF|CULPEO MINERALS LTD|Unknown|US
PLKT|SOLAR GOLD LTD|Unknown|US
HEGLF|LION ROCK MINERALS LTD|Unknown|US
ADSGF|ADESSO SE|Unknown|US
GPDB|GREEN POLKADOT BOX INC|Unknown|US
NTRP|NEXTTRIP INC|Unknown|US
MYFT|MYFREIGHTWORLD TECHNOLOGIES|Unknown|US
NEM|NEWMONT CORP|Unknown|US
SIIXF|SIIX CORP|Unknown|US
TKCM|TOKEN COMMUNITIES LTD|Unknown|US
RPKYS|RSE ARCHIVE LLC INT SER-1999|Unknown|US
CRDL|CARDIOL THERAPEUTICS INC-A|Unknown|US
AARLF|ASTRAL RESOURCES NL|Unknown|US
AITUF|ANRITSU CORP|Unknown|US
VRDDF|VERIDIS ENVIRONMENT LTD|Unknown|US
ITHLF|ITHACA ENERGY PLC|Unknown|US
ABANF|AUTOMATIC BANK SERVICES LTD|Unknown|US
BBVXF|BANCO BILBAO VIZCAYA ARGENTA|Unknown|US
ATHHF|AETHER CATALYST SOLUTIONS IN|Unknown|US
DDOG|DATADOG INC - CLASS A|Unknown|US
MKOEF|MEIKO ELECTRONICS CO LTD|Unknown|US
PDIV|PREMIER DEVELOPMENT & INVEST|Unknown|US
TEXG|TERAX ENERGY INC|Unknown|US
BGI|BIRKS GROUP INC|Unknown|US
FTFT|FUTURE FINTECH GROUP INC|Unknown|US
MWLMS|MASTERWORKS VAULT 4 SER 403|Unknown|US
SHHGF|SHENWAN HONGYUAN GROUP CO -H|Unknown|US
ADPT|ADAPTIVE BIOTECHNOLOGIES|Unknown|US
PGUUF|PROSEGUR CASH SA|Unknown|US
CBWA|COMMENCEMENT BANCORP INC|Unknown|US
ARSWF|ARISAWA MFG CO LTD|Unknown|US
CMC|COMMERCIAL METALS CO|Unknown|US
VVEGF|VIVA ENERGY GROUP LTD|Unknown|US
LOW|LOWE'S COS INC|Unknown|US
MASK|3 E NETWORK TECHNOLOGY GRP-A|Unknown|US
FPBC|FIRST PACIFIC BANCORP|Unknown|US
AMKAF|AP MOLLER-MAERSK A/S-A|Unknown|US
BLRK|BLUEROCK ACQUISITION CORP-A|Unknown|US
TVCE|TVC TELECOM INC|Unknown|US
CBFC|CNB FINANCIAL SERVICES INC|Unknown|US
BLRZF|BLACKHAWK GROWTH CORP|Unknown|US
LOVE|LOVESAC CO/THE|Unknown|US
XCFT|XCRAFT ENTERPRISES INC-CL B|Unknown|US
LINK|INTERLINK ELECTRONICS INC|Unknown|US
OZ|BELPOINTE PREP LLC- CLASS A|Unknown|US
RSVR|RESERVOIR MEDIA INC|Unknown|US
NPWR|NET POWER INC|Unknown|US
SNHO|SHONGHOYA INTERNATIONAL GROU|Unknown|US
SNTMF|SENSETIME GROUP INC-CLASS B|Unknown|US
ALNY|ALNYLAM PHARMACEUTICALS INC|Unknown|US
MRRDF|MERIDIAN MINING PLC|Unknown|US
ESNT|ESSENT GROUP LTD|Unknown|US
RVDRS|RSE COLLECTION LLC #VADER|Unknown|US
QNTPF|XTALPI HOLDINGS LTD|Unknown|US
EMLAF|EMPIRE CO LTD 'A'|Unknown|US
CBAN|COLONY BANKCORP|Unknown|US
CLOEF|CLOETTA AB-B SHS|Unknown|US
NASO|NAPLES SOAP CO INC|Unknown|US
ARGHF|ARGO CORP|Unknown|US
QS|QUANTUMSCAPE CORP|Unknown|US
TCNAF|TRANSCANNA HOLDINGS INC|Unknown|US
KICK|HPN HOLDINGS INC|Unknown|US
EDEYF|EDEN INNOVATIONS LTD|Unknown|US
SAYFF|3 SIXTY RISK SOLUTIONS LTD|Unknown|US
FGHQF|FRONTAGE HOLDINGS CORP|Unknown|US
RRRT|R-THREE TECHNOLOGIES INC|Unknown|US
RSCMS|1SE LLC SER FERRARI 348|Unknown|US
HWARF|HEIWA REAL ESTATE CO LTD|Unknown|US
AX|AXOS FINANCIAL INC|Unknown|US
PCQRF|PETROLYMPIC LTD|Unknown|US
NSMG|NATIONAL STORM MANAGEMENT|Unknown|US
OTTR|OTTER TAIL CORP|Unknown|US
BGTCF|BEIJING GEEKPLUS TECHNOLOG-H|Unknown|US
EWCLF|ENERGY WORLD CORP LTD|Unknown|US
WCCP|WEALTHCRAFT CAPITAL INC|Unknown|US
WPUR|WATERPURE INTERNATIONAL INC|Unknown|US
RAND|RAND CAPITAL CORP|Unknown|US
TBCCF|TBC BANK GROUP PLC|Unknown|US
DSOL|DRUG FREE SOLUTION INC|Unknown|US
LGVN|LONGEVERON INC-A|Unknown|US
JBARF|JULIUS BAER GROUP LTD|Unknown|US
REEMF|RARE ELEMENT RESOURCES LTD|Unknown|US
AXHNS|ARRIVED HOMES SER HANSEL|Unknown|US
RYAN|RYAN SPECIALTY HOLDINGS INC|Unknown|US
BTDR|BITDEER TECHNOLOGIES GROUP-A|Unknown|US
UVFT|UV FLU TECHNOLOGIES INC|Unknown|US
GFL|GFL ENVIRONMENTAL INC-SUB VT|Unknown|US
AHLNS|RSE ARCHIVE INT SER-07DURANT|Unknown|US
WSFL|WOODSTOCK HOLDINGS INC|Unknown|US
TIPNF|TYNER RESOURCES LTD|Unknown|US
IFBD|INFOBIRD CO LTD|Unknown|US
PHVS|PHARVARIS NV|Unknown|US
VC|VISTEON CORP|Unknown|US
SYNMF|SYNTHETICMR AB|Unknown|US
GARPF|GOLDEN AGRI-RESOURCES LTD|Unknown|US
ISTR|INVESTAR HOLDING CORP|Unknown|US
NPNKF|NIPPON SHINYAKU CO LTD|Unknown|US
ROIUF|ROUTE1 INC|Unknown|US
AHLJS|RSE ARCHIVE SER-13GIANNIS|Unknown|US
BEVFF|DIVERSIFIED ROYALTY CORP|Unknown|US
WKGFF|WESTKAM GOLD CORP|Unknown|US
CZFS|CITIZENS FINANCIAL SERVICES|Unknown|US
BHODF|B HODL PLC|Unknown|US
GALNF|GALENICA AG|Unknown|US
HAFC|HANMI FINANCIAL CORPORATION|Unknown|US
MWLOS|MASTERWORKS 168 LLC|Unknown|US
PTNM|PITANIUM LTD-CL A|Unknown|US
AKOM|AERKOMM INC|Unknown|US
BELFA|BEL FUSE INC-CL A|Unknown|US
BRRN|BORN INC|Unknown|US
EVLI|EVERLERT INC|Unknown|US
CRNRF|CARBINE RESOURCES LTD|Unknown|US
VITFF|VICTORIA GOLD CORP|Unknown|US
NPKYF|NIPPON KAYAKU CO LTD|Unknown|US
MNDR|MOBILE-HEALTH NETWORK SOLUTI|Unknown|US
JDVB|JD BANCSHARES INC|Unknown|US
HWBK|HAWTHORN BANCSHARES INC|Unknown|US
RSEVS|RSE ARCHIVE LLC SER- 03KOBE2|Unknown|US
EXXRF|EXOR NV|Unknown|US
VCTR|VICTORY CAPITAL HOLDING - A|Unknown|US
CXW|CORECIVIC INC|Unknown|US
KVLQF|VALORE METALS CORP|Unknown|US
AHCHF|ANHUI CONCH CEMENT CO LTD-H|Unknown|US
AVGDF|AVIDIAN GOLD CORP|Unknown|US
YASKF|YASKAWA ELECTRIC CORP|Unknown|US
PAY|PAYMENTUS HOLDINGS INC-A|Unknown|US
SGIOF|SHIONOGI & CO LTD|Unknown|US
CHUAF|CHINA CITIC FINANCIAL ASSE-H|Unknown|US
CUKPF|CARNIVAL PLC|Unknown|US
DLITF|DELTA LITHIUM LTD|Unknown|US
RVBR|MARKRAY CORP|Unknown|US
DAIC|CID HOLDCO INC|Unknown|US
AVBP|ARRIVENT BIOPHARMA INC|Unknown|US
DKTS|TOP SHELF BRANDS HOLDINGS CO|Unknown|US
UGIZ|UNIQUE GLOBAL INNOVATIVE SOL|Unknown|US
NWPX|NWPX INFRASTRUCTURE INC|Unknown|US
TTIPF|THIOGENESIS THERAPEUTICS COR|Unknown|US
LISMF|LITHIUM SOUTH DEVELOPMENT CO|Unknown|US
SNDX|SYNDAX PHARMACEUTICALS INC|Unknown|US
GYGLF|GUZMAN Y GOMEZ LTD|Unknown|US
AMKBF|AP MOLLER-MAERSK A/S-B|Unknown|US
PLFX|PULSE EVOLUTION CORP|Unknown|US
SACIF|SAKAI CHEMICAL INDUSTRY CO|Unknown|US
HLOSF|HEALIOS KK|Unknown|US
NETWF|NETWORK MEDIA GROUP INC|Unknown|US
TBRDF|THUNDERBIRD MINERALS CORP|Unknown|US
AGTK|AGRITEK HOLDINGS INC|Unknown|US
IBCP|INDEPENDENT BANK CORP - MICH|Unknown|US
CNDEF|CONDURIL ENGENHARIA SA|Unknown|US
PNXGF|PHOENIX GROUP HOLDINGS PLC|Unknown|US
HACBF|HACHIJUNI NAGANO BANK LTD|Unknown|US
MDSQF|MINSUD RESOURCES CORP|Unknown|US
UBFO|UNITED SECURITY BANCSHARE/CA|Unknown|US
KPOC|KIMBERLY PARRY ORGANICS CORP|Unknown|US
GPLB|GREEN PLANET BIO ENGINEERING|Unknown|US
BDRGF|JAEGER RESOURCES CORP|Unknown|US
RKSLF|RAKSUL INC|Unknown|US
TINLF|TEIJIN LTD|Unknown|US
MWKMS|MASTERWORKS 143 LLC|Unknown|US
HLISF|HELIOS TECHNO HOLDING CO LTD|Unknown|US
LFLS|LOANS4LESS.COM INC|Unknown|US
CAMJF|CANON MARKETING JAPAN INC|Unknown|US
NMEX|NORTHERN MINERALS & EXPLORAT|Unknown|US
CDELF|CANDELARIA MINING CORP|Unknown|US
PWMXF|POWERMAX MINERALS INC|Unknown|US
NCEL|NEWCELX LTD|Unknown|US
AIRJ|AIRJOULE TECHNOLOGIES CORP|Unknown|US
AVEXF|AVEX GROUP HOLDINGS INC|Unknown|US
CDNIF|LOGISTA INTEGRAL SA|Unknown|US
POST|POST HOLDINGS INC|Unknown|US
RLYGF|RILEY GOLD CORP|Unknown|US
CCDSF|CARRIER CONNECT DATA SOLUTIO|Unknown|US
AVMTS|ARRIVED HOMES 4 SER MONTEREY|Unknown|US
BLGCF|BULIGO CAPITAL LTD|Unknown|US
ENB|ENBRIDGE INC|Unknown|US
DHIL|DIAMOND HILL INVESTMENT GRP|Unknown|US
SGER|STERLING ENERGY RESOURCES|Unknown|US
CPNHF|KOBENHAVNS LUFTHAVNE|Unknown|US
AES|AES CORP|Unknown|US
MRWFS|MASTERWORKS 067 LLC|Unknown|US
VTXB|VORTEX BRANDS CO|Unknown|US
CSBI|CARROLL SHELBY INTERNATIONAL|Unknown|US
CUIRF|VELOX ENERGY MATERIALS INC|Unknown|US
DY|DYCOM INDUSTRIES INC|Unknown|US
PNRXF|PORTO ENERGY CORP|Unknown|US
NHESF|ESLEAD CORP|Unknown|US
NKSEF|NAKAKITA SEISAKUSHO CO LTD|Unknown|US
AGXKF|ANGLO ASIAN MINING PLC|Unknown|US
A|AGILENT TECHNOLOGIES INC|Unknown|US
WTXR|WEST TEXAS RESOURCES INC|Unknown|US
CANRF|CANARE ELECTRIC CO LTD|Unknown|US
OOMA|OOMA INC|Unknown|US
AVLOS|ARRIVED HOMES SER BILLINGSWO|Unknown|US
ITMSF|INTERMAP TECHNOLOGIES CORP|Unknown|US
RSCYS|RSE ARCHIVE LLC INT SER-2009|Unknown|US
FNNTF|FLATEXDEGIRO SE|Unknown|US
AXR|AMREP CORP|Unknown|US
MSWZS|MASTERWORKS 180 LLC|Unknown|US
SBBTF|VEND MARKETPLACES ASA CL|Unknown|US
XMTI|X METAVERSE INC|Unknown|US
OILEF|OILES CORP|Unknown|US
NET|CLOUDFLARE INC - CLASS A|Unknown|US
LVPA|LVPAI GROUP LTD|Unknown|US
PORBF|POLA ORBIS HOLDINGS INC|Unknown|US
MMI|MARCUS & MILLICHAP INC|Unknown|US
ITENF|ITOCHU ENEX CO LTD|Unknown|US
DRCT|DIRECT DIGITAL HOLDINGS IN-A|Unknown|US
PPTDF|PEPTIDREAM INC|Unknown|US
TPST|TEMPEST THERAPEUTICS INC|Unknown|US
ISVG|INTEGRATED SERVICES GROUP IN|Unknown|US
HYEVF|HYUNDAI ELEVATOR CO.|Unknown|US
ACNFF|ACOMO NV|Unknown|US
EB|EVENTBRITE INC-CLASS A|Unknown|US
DROHF|DEUTSCHE ROHSTOFF AG|Unknown|US
MBRX|MOLECULIN BIOTECH INC|Unknown|US
QNCX|QUINCE THERAPEUTICS INC|Unknown|US
RGCO|RGC RESOURCES INC|Unknown|US
ATUUF|TENAZ ENERGY CORP|Unknown|US
PNPFF|PINETREE CAPITAL LTD|Unknown|US
SRNW|STRATOS RENEWABLES CORP|Unknown|US
CMGR|CLUBHOUSE MEDIA GROUP INC|Unknown|US
ZNB|ZETA NETWORK GROUP|Unknown|US
GDXRF|GOLDEX RESOURCES CORP|Unknown|US
KDCCF|KADESTONE CAPITAL CORP|Unknown|US
BG|BUNGE GLOBAL SA|Unknown|US
NYC|AMERICAN STRATEGIC INVESTM-A|Unknown|US
TXN|TEXAS INSTRUMENTS INC|Unknown|US
CLMOF|CLIMEON AB|Unknown|US
EPWKF|EPWK HOLDINGS LTD-A|Unknown|US
SSD|SIMPSON MANUFACTURING CO INC|Unknown|US
CMGO|CMG HOLDINGS GROUP INC|Unknown|US
PEXZF|PACIFIC RIDGE EXPLORATION LT|Unknown|US
PTSFF|STEADY SAFE TBK PT|Unknown|US
MTSEF|MATSUI SECURITIES CO LTD|Unknown|US
EATR|EASTERN ASTERIA INC|Unknown|US
BEEI|BALD EAGLE ENERGY INC|Unknown|US
BSMAF|BURSA MALAYSIA BHD|Unknown|US
PENG|PENGUIN SOLUTIONS INC|Unknown|US
AQST|AQUESTIVE THERAPEUTICS INC|Unknown|US
TOGOF|TOMAGOLD CORP|Unknown|US
AAGR|AFRICAN AGRICULTURE HOLDINGS|Unknown|US
SYGGF|SYNAIRGEN PLC|Unknown|US
RWMI|REGALWORKS MEDIA INC|Unknown|US
BITTF|BITTERROOT RESOURCES LTD|Unknown|US
PLSDF|PULSE SEISMIC INC|Unknown|US
LCKYF|GOLDEN SKY MINERALS CORP-A|Unknown|US
DGWR|DEEP GREEN WASTE & RECYCLING|Unknown|US
QKIE|QKI EMULSION INC|Unknown|US
DTATF|DATA#3 LTD|Unknown|US
ALGLF|ALMA GOLD INC|Unknown|US
GITH|GLOBAL IT HOLDINGS INC|Unknown|US
WRLC|WINDROCK LTD CO|Unknown|US
BQST|BIOQUEST CORP|Unknown|US
NLPXF|NOBLE MINERAL EXPLORATION IN|Unknown|US
CETY|CLEAN ENERGY TECHNOLOGIES IN|Unknown|US
CTXDF|CANTEX MINE DEVELOPMENT CORP|Unknown|US
NCPCF|NICKEL CREEK PLATINUM CORP|Unknown|US
MXFFS|MASTERWORKS VAULT 4 SER 450|Unknown|US
EFXT|ENERFLEX LTD|Unknown|US
NCKIF|NICK SCALI LTD|Unknown|US
BKUH|BAKHU HOLDINGS CORP|Unknown|US
VQSSF|VIQ SOLUTIONS INC|Unknown|US
JYD|JAYUD GLOBAL LOGISTICS LTD-A|Unknown|US
VTDRF|VANTAGE DRILLING INTERNATION|Unknown|US
PFND|PATHFINDER CELL THERAPY INC|Unknown|US
RANJF|RANDSTAD NV|Unknown|US
SSP|EW SCRIPPS CO/THE-A|Unknown|US
FSBW|FS BANCORP INC|Unknown|US
KYBWF|GUANGDONG LAND HOLDINGS LTD|Unknown|US
NNRI|NNRF INC|Unknown|US
HTHL|HUMITECH INTERNATIONAL GROUP|Unknown|US
APCOF|AMERICAN CRITICAL MINERALS C|Unknown|US
BTDPF|BARRATT REDROW PLC|Unknown|US
WINA|WINMARK CORP|Unknown|US
GDIGF|NUCLEAR VISION LTD|Unknown|US
BCSS|BAIN CAPITAL GSS INV- A|Unknown|US
STJO|ST JOSEPH INC|Unknown|US
LKSP|LAKE SUPERIOR ACQUISITI-CL A|Unknown|US
ALTS|ALT5 SIGMA CORP|Unknown|US
TCRRF|TERRACE ENERGY CORP|Unknown|US
PTRUF|PETRUS RESOURCES LTD|Unknown|US
XTMM|XTREME MOTORSPORTS INTERNATI|Unknown|US
EORBF|ORBITE TECHNOLOGIES INC|Unknown|US
ROYIF|ROYALTIES INC|Unknown|US
BREUF|BRIDGEMARQ REAL ESTATE SERVI|Unknown|US
CRH|CRH PLC|Unknown|US
FNICF|FATHOM NICKEL INC|Unknown|US
NCKAF|NICKEL ASIA CORP|Unknown|US
FKST|FLOWERKIST SKIN CARE COSMETI|Unknown|US
WST|WEST PHARMACEUTICAL SERVICES|Unknown|US
VG|VENTURE GLOBAL INC-CL A|Unknown|US
AHFD|ACTIVE HEALTH FOODS INC|Unknown|US
TREP|AFINIDA INC|Unknown|US
BMDPF|BANCA MONTE DEI PASCHI SIENA|Unknown|US
TBLA|TABOOLA.COM LTD|Unknown|US
MMATQ|META MATERIALS INC|Unknown|US
HLPMF|HELLENIQ ENERGY HOLDINGS SA|Unknown|US
SCIA|SCI ENGINEERED MATERIALS INC|Unknown|US
MGAM|MOBILE GLOBAL ESPORTS INC|Unknown|US
STTFF|SMARTONE TELECOMMUNICATIONS|Unknown|US
TLCC|TWINLAB CONSOLIDATED HOLDING|Unknown|US
ETN|EATON CORP PLC|Unknown|US
ESQF|ESECURESOFT CO|Unknown|US
JLHL|JULONG HOLDING LTD|Unknown|US
SUIFF|SUPERIOR MINING INTERNATIONA|Unknown|US
HXPN|HARRIS EXPLORATION INC|Unknown|US
AOREF|AMERICAN OVERSEAS GROUP LTD|Unknown|US
MVTLS|MASTERWORKS VAULT 3 SER 414|Unknown|US
GOVB|GOUVERNEUR BANCORP INC|Unknown|US
NMHI|NATURE'S MIRACLE HOLDING INC|Unknown|US
DEMO|DEMOCRASOFT HOLDINGS INC|Unknown|US
IRSMF|IRESS LTD|Unknown|US
MHHC|MHHC ENTERPRISES INC|Unknown|US
NDATF|NDATALYZE CORP|Unknown|US
CMECF|COMPUTER ENGINEER & CONSULT|Unknown|US
HTGMQ|HTG MOLECULAR DIAGNOSTICS|Unknown|US
BOW|BOWHEAD SPECIALTY HOLDINGS I|Unknown|US
FUTL|FUTURELAND CORP|Unknown|US
IGIC|INTERNATIONAL GENERAL INSURA|Unknown|US
BOMXF|BOLSA MEXICANA DE VALORES SA|Unknown|US
STCGF|STACK CAPITAL GROUP INC|Unknown|US
WSZWF|WESIZWE PLATINUM LTD|Unknown|US
NORNQ|NORANDA ALUMINUM HOLDING COR|Unknown|US
AHGNS|ARRIVED HOMES LLC SER GEN|Unknown|US
TEKFF|GIG WORKS INC|Unknown|US
GNMRF|GREAT NORTHERN MINERALS LTD|Unknown|US
HDIUF|ADENTRA INC|Unknown|US
EMMRF|EMMERSON RESOURCES LTD|Unknown|US
TPCFF|TITAN LOGIX CORP|Unknown|US
CBNA|CHAIN BRIDGE BANCORP INC-A|Unknown|US
ACGL|ARCH CAPITAL GROUP LTD|Unknown|US
JBFCF|JOLLIBEE FOODS CORP|Unknown|US
JTEKF|JTEKT CORP|Unknown|US
HFBL|HOME FEDERAL BANCORP INC/LA|Unknown|US
BRC|BRADY CORPORATION - CL A|Unknown|US
CBBLF|CBLT INC|Unknown|US
IZEA|IZEA WORLDWIDE INC|Unknown|US
MRWAS|MASTERWORKS 165 LLC LTD|Unknown|US
HOCPF|HOYA CORP|Unknown|US
SGC|SUPERIOR GROUP OF COS INC|Unknown|US
LCGMF|LION COPPER AND GOLD CORP|Unknown|US
YPPN|YAPPN CORP|Unknown|US
TGLS|TECNOGLASS INC|Unknown|US
GCHT|GC CHINA TURBINE CORP|Unknown|US
NHYKF|NORSK HYDRO ASA|Unknown|US
MWQRS|MASTERWORKS 218 LLC|Unknown|US
SBBG|SEIBELS BRUCE GROUP INC|Unknown|US
IGPG|IGNIS PETROLEUM GROUP INC|Unknown|US
STXPF|ERANOVA METALS INC|Unknown|US
VNT|VONTIER CORP|Unknown|US
NMFC|NEW MOUNTAIN FINANCE CORP|Unknown|US
SMBMF|SEATRIUM LTD|Unknown|US
COMP|COMPASS INC - CLASS A|Unknown|US
CBUMF|CHINA NATIONAL BUILDING MA-H|Unknown|US
DECN|DECISION DIAGNOSTICS CORP|Unknown|US
SEHLF|SOLARGIGA ENERGY HOLDINGS LT|Unknown|US
AVNI|ARVANA INC|Unknown|US
NUGS|CANNABIS STRATEGIC VENTURES|Unknown|US
WWII|WORLD OF WIRELESS INTERNATIO|Unknown|US
PDGO|PARADIGM OIL AND GAS INC|Unknown|US
CTXV|CTX VIRTUAL TECHNOLOGIES INC|Unknown|US
MBOT|MICROBOT MEDICAL INC|Unknown|US
NTXVF|NEXTEER AUTOMOTIVE GROUP LTD|Unknown|US
GLNLF|GALAN LITHIUM LTD|Unknown|US
WDFN|WOODLANDS FINANCIAL SERVICES|Unknown|US
SYOIF|SANYO INDUSTRIES LTD|Unknown|US
SGMD|SUGARMADE INC|Unknown|US
BMHL|BLUEMOUNT HOLDINGS LTD-B|Unknown|US
OILAF|OPTISCAN IMAGING LTD|Unknown|US
BIQIF|BIQI INTERNATIONAL HOLDINGS|Unknown|US
IBAKF|INABA SEISAKUSHO CO LTD|Unknown|US
TTTNF|TITAN MINERALS LTD|Unknown|US
RGRNF|REGIS RESOURCES LTD|Unknown|US
MWQSS|MASTERWORKS 021 LLC|Unknown|US
TSN|TYSON FOODS INC-CL A|Unknown|US
CELC|CELCUITY INC|Unknown|US
TPZEF|TOPAZ ENERGY CORP|Unknown|US
MGTE|MARBLEGATE CAPITAL CORP|Unknown|US
NOEM|CO2 ENERGY TRANSITION CORP|Unknown|US
MXKNS|MASTERWORKS 193 LLC|Unknown|US
MTKTS|MASTERWORKS 127 LLC LTD CL A|Unknown|US
GRCE|GRACE THERAPEUTICS INC|Unknown|US
UNIT|UNITI GROUP INC|Unknown|US
VTMC|VALENTINE MARK CORP|Unknown|US
CVVLF|CARAVEL MINERALS LTD|Unknown|US
CNGA|CONAIR CORP/NEW YORK|Unknown|US
ACDXF|AMERICAN COPPER DEVELOPMENT|Unknown|US
CGMBF|CHINA MINSHENG BANKING COR-H|Unknown|US
MATEF|BLOCKMATE VENTURES INC|Unknown|US
CAMDF|CISARUA MOUNTAIN DAIRY PT TB|Unknown|US
NMMCF|NMC HEALTH PLC|Unknown|US
PRCH|PORCH GROUP INC|Unknown|US
NASC|NASCENT PHARMA HOLDINGS INC|Unknown|US
PXMBF|PAXMAN AB|Unknown|US
AHSNS|ARRIVED HOMES SER BONNEAU|Unknown|US
NXTP|NEXTPLAY TECHNOLOGIES INC|Unknown|US
CPIX|CUMBERLAND PHARMACEUTICALS|Unknown|US
IOFNF|IOFINA PLC|Unknown|US
EHC|ENCOMPASS HEALTH CORP|Unknown|US
TSSI|TSS INC|Unknown|US
GEV|GE VERNOVA INC|Unknown|US
PLLHF|GEMFIELDS GROUP LTD|Unknown|US
YDES|YD BIO LTD|Unknown|US
CUBI|CUSTOMERS BANCORP INC|Unknown|US
LIDR|AEYE INC|Unknown|US
WBUY|WEBUY GLOBAL LTD-CL A|Unknown|US
HEI|HEICO CORP|Unknown|US
IMDX|INSIGHT MOLECULAR DIAGNOSTIC|Unknown|US
ACON|ACLARION INC|Unknown|US
BGEM|BLUE GEM ENTERPRISE|Unknown|US
ISOLF|ISODIOL INTERNATIONAL INC|Unknown|US
HCMA|HCM III ACQUISITION COR-CL A|Unknown|US
SONIF|SONICSTRATEGY INC|Unknown|US
SEBC|SOUTHEASTERN BANKING CORP|Unknown|US
EPSFF|EPISURF MEDICAL AB-B SHS|Unknown|US
GBDC|GOLUB CAPITAL BDC INC|Unknown|US
WBS|WEBSTER FINANCIAL CORP|Unknown|US
NXTS|NEXENTIS TECHNOLOGIES INC|Unknown|US
MDNC|MEDINOTEC INC|Unknown|US
EMGE|EMERGENT HEALTH CORP|Unknown|US
TMICF|TREND MICRO INC|Unknown|US
KPGHF|KELLY PARTNERS GROUP HOLDING|Unknown|US
MNIZ|GEN2 TECHNOLOGIES INC|Unknown|US
ARGTF|ARTEMIS GOLD INC|Unknown|US
GMVMF|GMV MINERALS INC|Unknown|US
USB|US BANCORP|Unknown|US
ED|CONSOLIDATED EDISON INC|Unknown|US
ISASF|ISRAS HOLDINGS LTD|Unknown|US
KTSUF|KOATSU GAS KOGYO CO LTD|Unknown|US
MTG|MGIC INVESTMENT CORP|Unknown|US
HOUR|HOUR LOOP INC|Unknown|US
MONDQ|MONDEE HOLDINGS INC|Unknown|US
GNYPF|MASIVO SILVER CORP|Unknown|US
RNKGF|RENK GROUP AG|Unknown|US
IMAQ|INTERNATIONAL MEDIA ACQ-A|Unknown|US
GGBY|GO GO BUYERS|Unknown|US
WMK|WEIS MARKETS INC|Unknown|US
CM|CAN IMPERIAL BK OF COMMERCE|Unknown|US
ZDEC|ZENOVIA DIGITAL EXCHANGE COR|Unknown|US
VANTF|VANTEX RESOURCES LTD|Unknown|US
CFGX|CAPITAL FINANCIAL GLOBAL INC|Unknown|US
NPNTQ|NORTHPOINT COMMUNICATIONS|Unknown|US
BTRYF|WARATAH MINERALS LTD|Unknown|US
ELCO|ELCOM INTERNATIONAL INC|Unknown|US
SYNTF|SYNTHOLENE ENERGY CORP|Unknown|US
TRSO|TRANSUITE.ORG INC|Unknown|US
TPET|TRIO PETROLEUM CORP|Unknown|US
EVKG|EVER-GLORY INTERNATIONAL GRO|Unknown|US
ACLLF|ATCO LTD -CLASS I|Unknown|US
MTVX|APT MOTO VOX GROUP INC|Unknown|US
GNEYF|GENESIS ENERGY LTD|Unknown|US
EONXF|EONX TECHNOLOGIES INC|Unknown|US
NNGPF|NN GROUP NV|Unknown|US
INZRF|INARI AMERTRON BHD|Unknown|US
DKGR|UNIVERSAL APPAREL & TEXTILE|Unknown|US
MWKYS|MASTERWORKS 115 LLC LTD|Unknown|US
FFWM|FIRST FOUNDATION INC|Unknown|US
STRA|STRATEGIC EDUCATION INC|Unknown|US
ASHWS|ARRIVED HOMES 3 SER SHERWOOD|Unknown|US
TIL|INSTIL BIO INC|Unknown|US
AIVN|AMERICAN INTERNATIONAL VENT|Unknown|US
NINOF|NIKON CORP|Unknown|US
CSBB|CSB BANCORP INC|Unknown|US
FORU|FORU HOLDINGS INC|Unknown|US
EHGO|ESHALLGO INC|Unknown|US
CRTMF|CRITICAL METALS PLC|Unknown|US
CCB|COASTAL FINANCIAL CORP/WA|Unknown|US
HISEF|HISENSE HOME APPLIANCES GR-H|Unknown|US
PRTH|PRIORITY TECHNOLOGY HOLDINGS|Unknown|US
WMT|WALMART INC|Unknown|US
AFTLF|AFRIMAT LTD|Unknown|US
AUMC|AURYN MINING CORP|Unknown|US
GTMIF|GASTEM INC|Unknown|US
CCLHF|C C LAND HOLDINGS LTD|Unknown|US
MDNXF|MEDINEX LTD|Unknown|US
SROYF|SAILFISH ROYALTY CORP|Unknown|US
WASH|WASHINGTON TRUST BANCORP|Unknown|US
IPHYF|INNATE PHARMA SA|Unknown|US
MWVOS|MASTERWORKS VAULT 1 SER 339|Unknown|US
MEDVF|MEDIVOLVE INC|Unknown|US
LFCR|LIFECORE BIOMEDICAL INC|Unknown|US
MWRXS|MASTERWORKS 044 LLC|Unknown|US
KINS|KINGSTONE COS INC|Unknown|US
MWRSS|MASTERWORKS 148 LLC|Unknown|US
PNDZF|PANDORA A/S|Unknown|US
SGKBF|ST GALLER KANTONALBANK A-REG|Unknown|US
AVHTS|ARRIVED HOMES SER MOJAVE|Unknown|US
MEDP|MEDPACE HOLDINGS INC|Unknown|US
MRNA|MODERNA INC|Unknown|US
EKNCF|EIKEN CHEMICAL CO LTD|Unknown|US
FMZNF|QORIA LTD|Unknown|US
ALLO|ALLOGENE THERAPEUTICS INC|Unknown|US
AMTY|AMERITYRE CORP|Unknown|US
PFX|PHENIXFIN CORP|Unknown|US
MKOES|MASTERWORKS 086 LLC|Unknown|US
IPTK|AS-IP TECH INC|Unknown|US
BJJCF|BEIJING JINGNENG CLEAN ENE-H|Unknown|US
DSEAF|DEEP SEA MINERALS CORP|Unknown|US
HSFI|HOMELAND SAFETY INTERNATIONA|Unknown|US
UATG|UMBRA APPLIED TECHNOLOGIES G|Unknown|US
PMVP|PMV PHARMACEUTICALS INC|Unknown|US
STDE|STANDARD ENERGY CORP|Unknown|US
NFTI|NOFIRE TECHNOLOGIES INC|Unknown|US
NEOM|NEOMEDIA TECHNOLOGIES INC|Unknown|US
SYHO|SYNERGIE WELLNESS PRODUCTS I|Unknown|US
BEKSF|BEKAERT NV|Unknown|US
TYHJF|TYHEE GOLD CORP|Unknown|US
CSUI|CANNABIS SUISSE CORP|Unknown|US
SOLS|SOLSTICE ADV MATERIALS INC|Unknown|US
NNBKF|NANTO BANK LTD/THE|Unknown|US
VRNO|VERANO HOLDINGS CORP/NV|Unknown|US
WTBFB|WTB FINANCIAL CORP-CL B|Unknown|US
AETHF|AETHER GLOBAL INNOVATIONS CO|Unknown|US
BVAXF|BIOVAXYS TECHNOLOGY CORP|Unknown|US
XXII|22ND CENTURY GROUP INC|Unknown|US
DCFCQ|TRITIUM DCFC LTD|Unknown|US
TOOD|THERMWOOD CORP|Unknown|US
JACS|JACKSON ACQUISITION CO-CL A|Unknown|US
BNHUF|BONHEUR ASA|Unknown|US
GDISF|IGB BHD|Unknown|US
AKAN|AKANDA CORP|Unknown|US
IVBXF|INNOVENT BIOLOGICS INC|Unknown|US
CHUEF|CHUBU ELECTRIC POWER CO INC|Unknown|US
CRBAF|AGEREH TECHNOLOGIES INC|Unknown|US
IOIOF|IOI CORP BHD|Unknown|US
NGRBF|NEXTGEN FOOD ROBOTICS CORP|Unknown|US
NOAPF|NORDIC AQUA PARTNERS A/S|Unknown|US
BTGO|BITGO HOLDINGS INC-CL A|Unknown|US
CEPV|CANTOR EQUITY PARTNERS-CL A|Unknown|US
GPKE|GRAYSTONE PARK ENTERPRISES I|Unknown|US
LLKKF|LAKE RESOURCES NL|Unknown|US
POLA|POLAR POWER INC|Unknown|US
RELM|RELM HOLDINGS INC|Unknown|US
SEKYF|SEIKITOKYU KOGYO CO LTD|Unknown|US
AZIHF|AZIMUT HOLDING SPA|Unknown|US
AVTX|AVALO THERAPEUTICS INC|Unknown|US
XSNX|NOVACCESS GLOBAL INC|Unknown|US
REATS|RSE ARCHIVE INT SER-70AARON|Unknown|US
EPC|EDGEWELL PERSONAL CARE CO|Unknown|US
SENS|SENSEONICS HOLDINGS INC|Unknown|US
WFWRF|WI-FI WIRELESS LTD|Unknown|US
ABDDF|AB DYNAMICS PLC|Unknown|US
TRBO|TURBO GLOBAL PARTNERS INC|Unknown|US
EMBLF|EMBELLENCE GROUP AB|Unknown|US
GOGO|GOGO INC|Unknown|US
RES|RPC INC|Unknown|US
AFMDQ|AFFIMED NV|Unknown|US
MDLH|MEDICAL INTERNATIONAL TECHNO|Unknown|US
CYCMF|CYCLOPHARM LTD|Unknown|US
FTCHQ|FARFETCH LTD-CLASS A|Unknown|US
LVJYS|ARRIVED HOMES LLC SER LOVEJO|Unknown|US
KGHI|KAISER GROUP HOLDINGS INC|Unknown|US
PPINF|PHILIPPINE NATIONAL BANK|Unknown|US
GTHGF|GOLDEN THROAT HOLDINGS GROUP|Unknown|US
ABXXF|ABAXX TECHNOLOGIES IN|Unknown|US
OCGSF|OUTCROP SILVER & GOLD CORP|Unknown|US
HLNE|HAMILTON LANE INC-CLASS A|Unknown|US
ITXXF|ITACONIX PLC|Unknown|US
IVHI|INVECH HOLDINGS INC|Unknown|US
CHRUF|CHORUS LTD|Unknown|US
SVKEF|SKANDINAVISKA ENSKILDA BAN-A|Unknown|US
ANGO|ANGIODYNAMICS INC|Unknown|US
MBLMF|MOBILUM TECHNOLOGIES INC|Unknown|US
FEXRF|FENIX RESOURCES LTD|Unknown|US
JMPHF|LEVELJUMP HEALTHCARE CORP|Unknown|US
PXXLF|POXEL SA|Unknown|US
PNAGF|PETRONAS GAS BHD|Unknown|US
YWGRF|YOWIE GROUP LTD|Unknown|US
CNNN|CONNEXIONONE CORP|Unknown|US
NBR|NABORS INDUSTRIES LTD|Unknown|US
SEXHF|SICHUAN EXPRESSWAY CO-H|Unknown|US
HRZRF|HORIZON ROBOTICS INC|Unknown|US
LBYE|LIBERTY ENERGY CORP|Unknown|US
AMLTF|AMP LTD|Unknown|US
GLPT|GLOBAL PROFIT TECHNOLOGIES I|Unknown|US
RGDEF|RDX TECHNOLOGIES CORP|Unknown|US
GRDV|GOLDEN ROYAL DEVELOPMENT INC|Unknown|US
CNUN|COMMUNITY BANCSHARES INC/OH|Unknown|US
SPT|SPROUT SOCIAL INC - CLASS A|Unknown|US
TERA|TERAFORCE TECHNOLOGY CORP|Unknown|US
SR|SPIRE INC|Unknown|US
NXMR|NEXTMART INC|Unknown|US
CIVB|CIVISTA BANCSHARES INC|Unknown|US
MYPRF|MALAYSIA AIRPORTS HLDGS BHD|Unknown|US
MDMP|MDM PERMIAN INC|Unknown|US
QYOUF|QYOU MEDIA INC|Unknown|US
SOLBF|SOLVBL SOLUTIONS INC|Unknown|US
TPB|TURNING POINT BRANDS INC|Unknown|US
MTQCF|MTQ CORP LTD|Unknown|US
SRCRF|SCORPIO GOLD CORP|Unknown|US
JAXAF|VINYL GROUP LTD|Unknown|US
SNWV|SANUWAVE HEALTH INC|Unknown|US
GCAAF|GUARDIAN CAP GRP LTD-CL A|Unknown|US
BYRN|BYRNA TECHNOLOGIES INC|Unknown|US
CBAF|CITBA FINANCIAL CORP|Unknown|US
MLYS|MINERALYS THERAPEUTICS INC|Unknown|US
QEDN|QED CONNECT INC|Unknown|US
HPAI|HELPORT AI LTD|Unknown|US
ONGRF|ONGOLD RESOURCES LTD|Unknown|US
ARW|ARROW ELECTRONICS INC|Unknown|US
GTREF|LIVE ENERGY MINERALS CORP|Unknown|US
UHS|UNIVERSAL HEALTH SERVICES-B|Unknown|US
AAIGF|AIA GROUP LTD|Unknown|US
UPBD|UPBOUND GROUP INC|Unknown|US
EDUC|EDUCATIONAL DEVELOPMENT CORP|Unknown|US
DWAY|DRIVEITAWAY HOLDINGS INC|Unknown|US
CSNRF|CHESNARA PLC|Unknown|US
JUNS|JUPITER NEUROSCIENCES INC|Unknown|US
DTEGF|DEUTSCHE TELEKOM AG-REG|Unknown|US
MODVF|MELCOR DEVELOPMENTS LTD|Unknown|US
CHYMF|CAHYA MATA SARAWAK BHD|Unknown|US
DXTWF|RIVCO AUSTRALIA LTD|Unknown|US
ACVA|ACV AUCTIONS INC-A|Unknown|US
MOMT|MONEYONMOBILE INC|Unknown|US
GENLF|GENMIN LTD|Unknown|US
LNBY|LANDBAY INC - CL A|Unknown|US
IRIDQ|IRIDIUM WORLD COMM LTD-CL A|Unknown|US
AQUI|AQUAGOLD INTERNATIONAL INC|Unknown|US
IDA|IDACORP INC|Unknown|US
POCI|PRECISION OPTICS CORP INC|Unknown|US
SMPL|SIMPLY GOOD FOODS CO/THE|Unknown|US
HMRRF|HAMMER METALS LTD|Unknown|US
ARVPS|ARRIVED STR 2 LLC SER KNOLL|Unknown|US
ASMMF|AUSTRALIAN STRATEGIC MATERIA|Unknown|US
WWDH|WORLDWIDE HOLDINGS CORP|Unknown|US
RGXTF|REGENX TECH CORP|Unknown|US
PAWH|PENN WAREHOUSING & SAFE DEP|Unknown|US
UVSE|UNIVERSAL ENERGY CORP|Unknown|US
HEMP|HEMP INC|Unknown|US
MWOCS|MASTERWORKS 033 LLC|Unknown|US
ATPC|AGAPE ATP CORP|Unknown|US
NYUKF|NIPPON YUSEN KK|Unknown|US
RLGT|RADIANT LOGISTICS INC|Unknown|US
POLBF|POOLBEG PHARMA PLC|Unknown|US
SUTAF|INVESTIGATOR SILVER LTD|Unknown|US
RDYFF|NEWPATH RESOURCES INC|Unknown|US
WRRZF|WALKER RIVER RESOURCES CORP|Unknown|US
NFSE|NFINANSE INC|Unknown|US
GMEGF|GME GROUP HOLDINGS LTD|Unknown|US
MLMN|MILLENNIUM PRIME INC|Unknown|US
ATMQF|ATEAM HOLDINGS CO LTD|Unknown|US
SDGR|SCHRODINGER INC|Unknown|US
HNTGF|CHINA RUYI HOLDINGS LTD|Unknown|US
THCT|THC THERAPEUTICS INC|Unknown|US
FRGT|FREIGHT TECHNOLOGIES INC|Unknown|US
RSRBF|ROBEX RESOURCES INC|Unknown|US
BWTL|BOWLIN TRAVEL CENTERS INC|Unknown|US
TNREF|TARANIS RESOURCES INC|Unknown|US
XALL|XALLES HOLDINGS INC|Unknown|US
PLUG|PLUG POWER INC|Unknown|US
NXAGF|NEXTAGE CO LTD|Unknown|US
EMPHF|EMPATHO HOLDINGS INC|Unknown|US
HASTF|HAMAK STRATEGY LTD|Unknown|US
WTSHF|WESTSHORE TERMINALS INVESTME|Unknown|US
INFT|INFINITY BANCORP|Unknown|US
STMEF|STMICROELECTRONICS NV|Unknown|US
AAPJ|AAP INC|Unknown|US
OLYFF|OLYMPIA FINANCIAL GROUP INC|Unknown|US
RARMF|CADENCE MINERALS PLC|Unknown|US
NHHPF|NISHI-NIPPON FINANCIAL HOLDI|Unknown|US
HAFN|HAFNIA LTD|Unknown|US
DEWY|DEWEY ELECTRONICS CORP|Unknown|US
CIA|CITIZENS INC|Unknown|US
MSWAS|MASTERWORKS 037 LLC|Unknown|US
UGHB|UNIVERSAL GLOBAL HUB INC|Unknown|US
TMVWF|TEAMVIEWER SE|Unknown|US
KAMRF|KALAMAZOO RESOURCES LIMITED|Unknown|US
RHLD|RESOLUTE HOLDINGS MANAG|Unknown|US
HLLXF|HELLIX VENTURES INC|Unknown|US
PRDL|PROFITABLE DEVELOPMENTS INC|Unknown|US
EZES|EASY ENVIRONMENTAL SOLUTIONS|Unknown|US
SFDL|SECURITY FEDERAL CORP|Unknown|US
GGCPF|GENERIC GOLD CORP|Unknown|US
EVRN|EVEROCK INC|Unknown|US
LII|LENNOX INTERNATIONAL INC|Unknown|US
